2000000000000000000000000000000002000002fffff
1       1         1              1     1fffff
1  3    2         1       3      2     1fffff
1                 1     2   2          1fffff
1                 2     1   1    2     1fffff
1                       1   22   1     1fffff
1       2               1    1   1  3  1fffff
1002  20002 2002    2   1    2   1     200001
1                       1        1          1
1                       1        1          1
1        4         200001    20002     202  1
1                       1              1f1  1
1                       1              1f1  1
1        2      3       2    4   2     1f1  1
1        1                       1     1f1  1
1      4 1                       1     1f1  1
1        1                       1     1f1  1
102 200000000002       2         1     1f1  1
1            1         1         1     1f1  1
1            1         1     3   1  4  1f1  1
1       3    1         1         1     1f1  1
1            1         1        2000000002  1
1    2       2         1        2           1
1    1                 2                    1
1    1                                      1
1    1          4               2           1
22  2000000000000000000002  20001      4    1
f1  1                 1         1002   200001
f1  1       3      4  1         2           1
f1  22 2000000000000002                     1
f1                                     3    1
f1                              2           1
f1000000000000000000002  4      1           1
ffffffffffffffffffffff20000000000000000000001
